23 2 2 2 2 2 2 2 2 2 2 2 2 2 2 2 2 2 2 2 2 2 2 2 2 2 2 2 2 2 2 2 2 2 2 2 2 2 2 23 
23 20 22 2 2 2 2 2 2 2 2 2 2 2 2 2 2 2 2 2 2 2 2 2 2 2 2 2 2 2 2 2 2 2 2 2 2 21 20 23
23 0 0 22 2 2 2 2 2 2 2 2 2 2 2 2 2 2 2 2 2 2 2 2 2 2 2 2 2 2 2 2 2 2 2 2 21 7 23 23
23 0 0 0 20 22 2 2 2 2 2 2 2 2 2 2 2 2 2 2 2 2 2 2 2 2 2 2 2 2 2 2 2 2 21 20 7 23 23 23
23 0 0 0 0 0 20 22 2 2 2 2 2 2 2 2 2 2 2 2 2 2 2 2 2 2 8 2 2 2 2 2 21 20 7 4 23 23 23 23
23 0 0 0 0 0 7 0 20 22 2 2 2 2 2 2 2 2 2 2 2 8 2 2 2 2 2 2 2 2 21 20 0 4 23 3 0 7 23 23 
23 0 7 7 0 7 0 0 0 0 20 20 22 2 2 2 2 8 2 9 2 2 2 8 8 2 2 21 20 20 0 4 4 24 24 7 7 24 23 23
23 0 7 7 0 0 0 7 0 7 7 0 0 20 20 22 2 2 2 2 2 2 2 8 21 20 20 0 3 4 24 0 3 0 7 7 24 24 23 23
23 0 7 7 0 0 7 0 7 7 0 0 0 0 0 0 22 2 2 2 2 8 2 2 16 10 11 4 7 4 24 23 0 7 3 24 24 23 23 23
23 0 7 7 0 0 7 0 0 0 0 0 0 0 0 0 19 2 2 8 2 2 2 2 16 12 13 0 7 23 23 24 0 7 7 7 24 23 23 23
23 0 7 7 7 7 0 0 7 0 0 7 7 0 0 0 19 2 2 2 9 2 2 2 16 0 0 0 0 7 24 3 10 11 7 7 7 24 23 23
23 0 7 7 7 7 7 7 0 0 0 0 0 7 0 18 15 2 2 2 2 8 2 2 16 0 7 4 7 0 0 0 12 13 7 7 7 3 7 23
23 0 0 0 7 7 7 7 7 7 0 0 0 0 7 19 2 2 8 2 2 2 2 21 0 0 0 0 0 7 0 0 7 7 7 24 24 7 3 23
23 0 0 0 0 0 0 7 7 7 7 0 0 7 7 7 25 25 25 25 25 25 25 7 7 0 0 0 0 7 7 3 7 7 24 24 23 24 23 23
23 0 0 0 0 0 0 0 0 7 7 7 7 7 7 7 25 25 25 25 25 25 25 7 7 7 7 3 0 0 7 7 0 3 24 7 24 23 23 23
23 0 0 0 0 0 0 7 0 0 7 7 7 7 0 18 25 25 25 25 25 25 25 17 7 7 7 7 4 7 7 0 0 24 0 24 24 23 23 23
23 0 0 0 0 0 7 7 0 7 7 7 0 0 0 19 2 8 2 8 8 2 2 14 17 0 7 7 7 0 0 7 24 7 24 3 24 24 23 23
23 0 0 0 0 0 7 0 0 7 7 0 7 0 0 0 22 2 8 2 8 9 8 2 16 0 0 0 0 0 7 3 0 0 0 24 7 24 23 23
23 0 0 0 7 7 0 0 0 7 7 0 0 0 7 0 19 9 2 8 3 2 2 8 16 0 0 0 0 0 0 0 0 7 3 24 4 24 23 23
23 0 0 0 7 7 7 0 7 7 7 0 7 0 0 0 15 8 2 10 11 7 2 8 16 0 7 0 0 7 0 7 0 0 3 4 7 7 23 23
23 0 0 0 0 0 7 7 7 7 0 0 0 7 0 19 25 25 7 12 13 25 25 21 0 0 7 0 0 0 7 0 0 10 11 7 7 24 7 23
23 0 0 0 0 0 7 7 7 7 0 7 7 0 0 19 2 8 7 7 7 9 2 16 0 0 0 7 0 0 0 7 3 12 13 7 24 24 23 23
23 0 0 0 0 0 0 0 7 7 0 0 0 7 0 19 2 9 2 8 2 8 8 14 17 0 0 0 0 0 0 0 0 7 7 3 24 23 23 23
23 0 0 0 0 0 7 0 7 7 0 0 0 0 0 7 22 2 8 2 2 8 2 2 16 0 0 0 0 0 0 7 7 7 0 24 24 23 23 23
23 0 0 0 0 7 0 0 0 7 7 0 0 0 0 7 7 25 25 25 25 25 25 25 7 7 0 0 0 4 7 7 7 7 7 7 24 24 23 23
23 0 0 0 0 0 0 7 7 7 7 7 0 0 7 7 7 25 25 25 25 25 25 25 7 7 7 0 0 3 7 7 4 4 7 3 7 24 23 23
23 0 0 0 0 7 7 7 7 0 7 7 7 7 7 7 18 25 25 25 25 25 25 25 17 7 7 7 7 7 7 4 3 24 24 7 7 7 23 23
23 0 0 0 0 0 7 0 0 0 7 7 7 7 0 18 15 2 2 2 8 8 9 2 16 0 7 7 7 7 0 0 3 4 24 24 7 7 24 23
23 0 0 0 0 0 0 0 0 7 7 7 0 0 0 19 2 2 2 2 8 2 2 21 0 0 0 7 0 7 7 0 0 24 24 23 24 24 23 23
23 0 0 0 0 7 0 0 7 7 7 7 0 7 0 19 2 8 9 2 2 2 2 16 0 0 0 0 0 0 7 7 3 0 0 24 24 23 23 23
23 0 0 0 0 0 7 7 7 7 0 7 7 0 0 19 2 2 2 2 2 2 2 16 0 0 0 0 0 0 0 7 7 7 3 24 23 24 23 23
23 0 0 0 0 0 7 7 0 0 0 0 7 7 0 19 2 2 2 8 26 26 26 14 17 0 0 0 0 7 7 0 7 7 7 3 24 7 23 23
23 0 0 0 0 7 7 0 7 0 7 0 0 0 0 0 22 26 26 26 27 27 27 6 16 0 0 0 7 7 0 0 10 11 7 7 7 24 23 23
23 0 7 7 7 7 7 0 0 7 0 0 0 18 5 15 6 27 27 27 2 2 2 2 14 5 17 0 0 0 0 0 12 13 24 24 7 24 23 23
23 7 7 7 7 7 0 0 0 0 0 18 5 15 6 6 2 2 2 2 2 2 2 2 6 6 14 5 17 0 0 0 7 7 24 23 24 7 24 23
23 7 0 0 0 0 0 0 18 5 5 15 6 6 2 2 2 2 2 2 2 2 2 2 2 2 6 6 14 5 5 17 0 7 23 4 23 23 23 23
23 0 0 0 0 0 0 18 15 6 6 6 2 2 2 2 2 2 2 2 2 2 2 2 2 2 2 2 6 6 6 14 5 17 0 4 7 4 23 23
23 5 5 5 5 5 5 15 6 2 2 2 2 2 2 2 2 2 2 2 2 2 2 2 2 2 2 2 2 2 2 6 6 14 5 5 5 5 5 23
6 6 6 6 6 6 6 6 2 2 2 2 2 2 2 2 2 2 2 2 2 2 2 2 2 2 2 2 2 2 2 2 2 6 6 6 6 6 6 6 
2 2 2 2 2 2 2 2 2 2 2 2 2 2 2 2 2 2 2 2 2 2 2 2 2 2 2 2 2 2 2 2 2 2 2 2 2 2 2 2 